........................................
........................................
......########..........................
......#......#..........................
......#......#..........................
......#......#..........................
......#......#..........................
......#......#..........................
......#......#..........................
......#......#..........................
......########..........................
........................................
........................................
........................................
........................................
........................................
........................................
........................................
........................................
........................................
........................................
........................................
........................................
........................................
........................................
........................................
........................................
........................................
........................................
........................................
........................................
........................................
.........#########......................
.........#.......#......................
.........#.......#...########...........
.........#.......#...#......#...........
.........#.......#...#......#...........
.........#.......#...#......#...........
.........#########...########...........
........................................
