#####################################
#...................................#
#...................................#
#....####...................####....#
#....#.........................#....#
#....#.........................#....#
#....#............#............#....#
#................###................#
#................###................#
#....#............#............#....#
#....#.........................#....#
#....#.........................#....#
#....####...................####....#
#...................................#
#...................................#
#####################################
